{
	"numTilesX": 15,
	"numTilesY": 11,
	"start": [-32, 32],
	"size": [64, 64],
	"tileNames": ["", "tile01", "tile02", "tile03", "tile04", "tile05", "tile06"],
	"tiles":[
			5, 0, 0, 0, 0, 0, 0, 0, 0, 0, 0, 0, 0, 0, 5,
			5, 0, 0, 0, 0, 0, 0, 0, 0, 0, 0, 0, 0, 0, 5,
			5, 0, 0, 0, 0, 0, 0, 0, 0, 0, 0, 0, 0, 0, 5,
			5, 0, 0, 0, 0, 0, 0, 0, 0, 0, 0, 0, 0, 0, 5,
			5, 0, 0, 0, 0, 6, 6, 6, 6, 6, 0, 0, 0, 0, 5,
			5, 0, 0, 0, 0, 0, 0, 0, 0, 0, 0, 0, 0, 0, 5,
			5, 0, 0, 0, 0, 0, 0, 0, 0, 0, 0, 0, 0, 0, 5,
			5, 0, 0, 0, 0, 0, 0, 0, 0, 0, 0, 0, 0, 0, 5,
			5, 2, 3, 4, 1, 2, 3, 4, 1, 2, 3, 4, 1, 2, 5,
			5, 4, 1, 2, 3, 4, 1, 2, 3, 4, 1, 2, 3, 4, 5
			]
}